"filename", "language", "PHP", "Log", "comment", "blank", "total"
"f:\Project\工作文件夹\MiraiTravel\components\easyMirai\V0.1.1\easyMirai.php", "PHP", 3, 0, 0, 1, 4
"f:\Project\工作文件夹\MiraiTravel\components\webhook\V0.1.1\webhook.php", "PHP", 17, 0, 0, -1, 16
"f:\Project\工作文件夹\MiraiTravel\core\messageChain.php", "PHP", 3, 0, 0, 1, 4
"f:\Project\工作文件夹\MiraiTravel\core\plugin.php", "PHP", 17, 0, 9, 12, 38
"f:\Project\工作文件夹\MiraiTravel\core\pluginSystem.php", "PHP", 40, 0, 9, 11, 60
"f:\Project\工作文件夹\MiraiTravel\core\qqObj.php", "PHP", 28, 0, 1, 1, 30
"f:\Project\工作文件夹\MiraiTravel\logs\Script\2771717841\Script.log", "Log", 0, -91, 0, 0, -91
"f:\Project\工作文件夹\MiraiTravel\logs\Script\2771717841\script.log", "Log", 0, 102, 0, 0, 102
"f:\Project\工作文件夹\MiraiTravel\logs\Script\2771717841\sendMessage.log", "Log", 0, 4, 0, 0, 4
"f:\Project\工作文件夹\MiraiTravel\logs\Script\2771717841\webhook.log", "Log", 0, 75, 0, 0, 75
"f:\Project\工作文件夹\MiraiTravel\logs\httpAdapter.log", "Log", 0, 18, 0, 0, 18
"f:\Project\工作文件夹\MiraiTravel\logs\miraiApiHttp.log", "Log", 0, 8, 0, 0, 8
"f:\Project\工作文件夹\MiraiTravel\logs\webhook.log", "Log", 0, 8, 0, 0, 8
"f:\Project\工作文件夹\MiraiTravel\plugins\bilibiliFans\V0.1.0\bilibiliFans.php", "PHP", 58, 0, 0, 12, 70
"f:\Project\工作文件夹\MiraiTravel\plugins\runoobC\V0.1.0\runoobC.php", "PHP", 125, 0, 0, 14, 139
"f:\Project\工作文件夹\MiraiTravel\script\Q2771717841.php", "PHP", -104, 0, 0, -6, -110
"f:\Project\工作文件夹\MiraiTravel\webhook.php", "PHP", 3, 0, 0, 2, 5
"Total", "-", 190, 124, 19, 47, 380